Cat : Bat
Dog : Log
Bear : Pear
Frog : Log
Duck : Luck
Bee : Sea
Shark : Bark
Lynx : Links
Seal : Heal
Mouse : House
Ant : Plant
Crow : Grow
Deer : Gear
Fish : Dish
Hawk : Walk
Lamb : Jam
Crab : Grab
Swan : Dawn
Whale : Trail
Eagle : Beagle
Turtle : Hurdle
Vole : Coal
Falcon : Bison
Lizard : Wizard
Hedgehog : Log
Cheetah : Pita
Owl : Fowl
Panda : Bandana
Mole : Role
Tiger : Rigor
Cactus : Practice
Fern : Learn
Rose : Nose
Tulip : Clip
Daisy : Crazy
Maple : Grapple
Pine : Line
Moss : Loss
Oak : Joke
Bamboo : Moo
Clover : Hover
Willow : Pillow
Cypress : Hypnosis
Mint : Hint
Ivy : Jive
Lotus : Focus
Lily : Silly
Cedar : Leader
Birch : Search
Aspen : Spent
