Cake : Bake
Bread : Spread
Peach : Beach
Chili : Silly
Steak : Shake
Pasta : Fasta
Rice : Slice
Taco : Waco
Berry : Merry
Mango : Tango
Nut : Gut
Soda : Yoda
Pork : Cork
Fish : Dish
Chips : Dips
Jam : Clam
Salad : Ballad
Cereal : Serial
Cookie : Rookie
Kale : Pale
Lemon : Demon
Onion : Funion
Muffin : Toughen
Honey : Money
Pear : Care
Grape : Tape
Meat : Seat
Pepper : Stepper
Salt : Vault
Sugar : Ruger
Spice : Slice
Herb : Verb
Tea : Fee
Coffee : Toffee
Milk : Silk
Egg : Peg
Raisin : Basin
Candy : Dandy
Pie : Sky
Cake : Make
Donut : Cone Nut
Fruit : Suit
Nuts : Cuts
Seeds : Leads
Wheat : Beat
Oat : Coat
Barley : Charley
Corn : Torn
Saffron : Marathon
Ginger : Minger
Cinnamon : Minivan
Turmeric : Numeric
Paprika : Pica
Garlic : Parlic
Onion : Minion
Mushroom : Gloom
Truffle : Shuffle
Sausage : Passage
